###############
#------#------#
#---#--#------#
#--------#----#
#------#------#
#------#------#
###-#######-###
#----##-------#
#-----#----#--#
#-------------#
#-----#-------#
#-----#-------#
###############