----------
---#------
--------#-
----------
--#-------
----------
----#-----
----------
-------#--
----------