#######
###-###
#1---2#
###-###
#######
